{
  "NY": 18,
  "NM": 4,
  "ND": 2,
  "TX": 43,
  "MD": 10,
  "OK": 5,
  "MS": 1,
  "WA": 16,
  "ME": 6,
  "MI": 7,
  "CO": 8,
  "VA": 3,
  "FL": 18,
  "OR": 2,
  "VT": 4,
  "HI": 2,
  "CT": 1,
  "TN": 5,
  "AL": 3,
  "CA": 21,
  "LA": 6,
  "NC": 7,
  "SC": 3,
  "NJ": 4,
  "GA": 5,
  "KY": 3,
  "MA": 5,
  "MO": 1,
  "DE": 2,
  "WI": 4,
  "NH": 2,
  "AR": 3,
  "MT": 3,
  "AZ": 5,
  "MN": 12,
  "AK": 4,
  "UT": 2,
  "IN": 2,
  "ID": 3,
  "IA": 2,
  "PA": 1,
  "NE": 1,
  "NV": 1
}