{
  "NY": 17,
  "NM": 4,
  "ND": 2,
  "TX": 41,
  "MD": 10,
  "OK": 4,
  "MS": 1,
  "WA": 15,
  "ME": 6,
  "MI": 6,
  "CO": 8,
  "VA": 3,
  "FL": 17,
  "OR": 2,
  "VT": 4,
  "HI": 2,
  "CT": 1,
  "TN": 5,
  "AL": 3,
  "CA": 20,
  "LA": 6,
  "NC": 7,
  "SC": 3,
  "NJ": 4,
  "GA": 4,
  "KY": 3,
  "MA": 4,
  "MO": 1,
  "DE": 2,
  "WI": 3,
  "NH": 2,
  "AR": 3,
  "MT": 2,
  "AZ": 4,
  "MN": 11,
  "AK": 3,
  "UT": 1,
  "IN": 1,
  "ID": 2,
  "IA": 2,
  "PA": 1,
  "NE": 1
}