{
  "NY": 4,
  "NM": 1,
  "ND": 1,
  "TX": 5,
  "MD": 5,
  "OK": 3,
  "MS": 1,
  "WA": 3,
  "ME": 1,
  "MI": 3,
  "CO": 2,
  "VA": 1,
  "FL": 2,
  "OR": 1,
  "VT": 3,
  "HI": 1,
  "CT": 1
}