{
  "NY": 25,
  "NM": 5,
  "ND": 3,
  "TX": 58,
  "MD": 13,
  "OK": 5,
  "MS": 3,
  "WA": 41,
  "ME": 9,
  "MI": 9,
  "CO": 10,
  "VA": 4,
  "FL": 27,
  "OR": 2,
  "VT": 4,
  "HI": 3,
  "CT": 2,
  "TN": 6,
  "AL": 4,
  "CA": 26,
  "LA": 7,
  "NC": 10,
  "SC": 3,
  "NJ": 4,
  "GA": 8,
  "KY": 3,
  "MA": 5,
  "MO": 2,
  "DE": 2,
  "WI": 4,
  "NH": 3,
  "AR": 3,
  "MT": 4,
  "AZ": 6,
  "MN": 13,
  "AK": 12,
  "UT": 3,
  "IN": 3,
  "ID": 3,
  "IA": 2,
  "PA": 1,
  "NE": 2,
  "NV": 2,
  "RI": 1,
  "IL": 2,
  "OH": 1
}