{
  "NY": 3,
  "NM": 1,
  "ND": 1,
  "TX": 5,
  "MD": 4,
  "OK": 2,
  "MS": 1,
  "WA": 1
}