{
  "NY": 22,
  "NM": 4,
  "ND": 3,
  "TX": 53,
  "MD": 10,
  "OK": 5,
  "MS": 2,
  "WA": 26,
  "ME": 9,
  "MI": 8,
  "CO": 10,
  "VA": 3,
  "FL": 22,
  "OR": 2,
  "VT": 4,
  "HI": 2,
  "CT": 1,
  "TN": 6,
  "AL": 4,
  "CA": 22,
  "LA": 6,
  "NC": 7,
  "SC": 3,
  "NJ": 4,
  "GA": 7,
  "KY": 3,
  "MA": 5,
  "MO": 1,
  "DE": 2,
  "WI": 4,
  "NH": 2,
  "AR": 3,
  "MT": 4,
  "AZ": 5,
  "MN": 12,
  "AK": 9,
  "UT": 2,
  "IN": 2,
  "ID": 3,
  "IA": 2,
  "PA": 1,
  "NE": 2,
  "NV": 1,
  "RI": 1,
  "IL": 1
}