{
  "NY": 12,
  "NM": 2,
  "ND": 2,
  "TX": 13,
  "MD": 7,
  "OK": 4,
  "MS": 1,
  "WA": 13,
  "ME": 3,
  "MI": 4,
  "CO": 6,
  "VA": 1,
  "FL": 11,
  "OR": 2,
  "VT": 4,
  "HI": 1,
  "CT": 1,
  "TN": 1,
  "AL": 2,
  "CA": 11,
  "LA": 2,
  "NC": 5,
  "SC": 1,
  "NJ": 4,
  "GA": 2,
  "KY": 2,
  "MA": 3,
  "MO": 1,
  "DE": 2,
  "WI": 1,
  "NH": 1,
  "AR": 3,
  "MT": 1,
  "AZ": 1,
  "MN": 3,
  "AK": 1,
  "UT": 1
}