{
  "NY": 7,
  "NM": 1,
  "ND": 1,
  "TX": 7,
  "MD": 6,
  "OK": 3,
  "MS": 1,
  "WA": 5,
  "ME": 1,
  "MI": 3,
  "CO": 2,
  "VA": 1,
  "FL": 7,
  "OR": 1,
  "VT": 4,
  "HI": 1,
  "CT": 1,
  "TN": 1,
  "AL": 2,
  "CA": 2,
  "LA": 1,
  "NC": 1,
  "SC": 1,
  "NJ": 1,
  "GA": 1
}