{
  "NY": 29,
  "NM": 5,
  "ND": 3,
  "TX": 60,
  "MD": 14,
  "OK": 5,
  "MS": 4,
  "WA": 45,
  "ME": 11,
  "MI": 9,
  "CO": 11,
  "VA": 6,
  "FL": 28,
  "OR": 2,
  "VT": 5,
  "HI": 3,
  "CT": 2,
  "TN": 8,
  "AL": 5,
  "CA": 34,
  "LA": 7,
  "NC": 10,
  "SC": 3,
  "NJ": 5,
  "GA": 13,
  "KY": 3,
  "MA": 5,
  "MO": 2,
  "DE": 2,
  "WI": 4,
  "NH": 4,
  "AR": 3,
  "MT": 4,
  "AZ": 7,
  "MN": 13,
  "AK": 13,
  "UT": 7,
  "IN": 3,
  "ID": 3,
  "IA": 2,
  "PA": 2,
  "NE": 2,
  "NV": 2,
  "RI": 1,
  "IL": 4,
  "OH": 1,
  "KS": 2
}