{
  "NY": 4,
  "NM": 1,
  "ND": 1,
  "TX": 5,
  "MD": 5,
  "OK": 2,
  "MS": 1,
  "WA": 2,
  "ME": 1,
  "MI": 1,
  "CO": 2,
  "VA": 1,
  "FL": 1
}