{
  "NY": 17,
  "NM": 4,
  "ND": 2,
  "TX": 42,
  "MD": 10,
  "OK": 4,
  "MS": 1,
  "WA": 15,
  "ME": 6,
  "MI": 7,
  "CO": 8,
  "VA": 3,
  "FL": 18,
  "OR": 2,
  "VT": 4,
  "HI": 2,
  "CT": 1,
  "TN": 5,
  "AL": 3,
  "CA": 20,
  "LA": 6,
  "NC": 7,
  "SC": 3,
  "NJ": 4,
  "GA": 4,
  "KY": 3,
  "MA": 5,
  "MO": 1,
  "DE": 2,
  "WI": 4,
  "NH": 2,
  "AR": 3,
  "MT": 3,
  "AZ": 5,
  "MN": 11,
  "AK": 3,
  "UT": 2,
  "IN": 2,
  "ID": 3,
  "IA": 2,
  "PA": 1,
  "NE": 1
}