{
  "NY": 1,
  "NM": 1,
  "ND": 1,
  "TX": 3,
  "MD": 3,
  "OK": 1,
  "MS": 1
}