{
  "NY": 1,
  "NM": 1,
  "ND": 1,
  "TX": 1,
  "MD": 2,
  "OK": 1
}