{
  "NY": 36,
  "NM": 5,
  "ND": 3,
  "TX": 63,
  "MD": 14,
  "OK": 5,
  "MS": 6,
  "WA": 49,
  "ME": 16,
  "MI": 12,
  "CO": 13,
  "VA": 9,
  "FL": 28,
  "OR": 5,
  "VT": 5,
  "HI": 4,
  "CT": 2,
  "TN": 10,
  "AL": 5,
  "CA": 38,
  "LA": 10,
  "NC": 12,
  "SC": 6,
  "NJ": 6,
  "GA": 14,
  "KY": 5,
  "MA": 5,
  "MO": 3,
  "DE": 2,
  "WI": 5,
  "NH": 4,
  "AR": 3,
  "MT": 4,
  "AZ": 8,
  "MN": 13,
  "AK": 14,
  "UT": 10,
  "IN": 5,
  "ID": 4,
  "IA": 2,
  "PA": 2,
  "NE": 2,
  "NV": 2,
  "RI": 1,
  "IL": 11,
  "OH": 2,
  "KS": 2,
  "WY": 1,
  "SD": 1
}