{
  "NY": 2,
  "NM": 1,
  "ND": 1,
  "TX": 4,
  "MD": 3,
  "OK": 1,
  "MS": 1
}