{
  "NY": 8,
  "NM": 1,
  "ND": 2,
  "TX": 12,
  "MD": 6,
  "OK": 4,
  "MS": 1,
  "WA": 11,
  "ME": 3,
  "MI": 3,
  "CO": 4,
  "VA": 1,
  "FL": 9,
  "OR": 1,
  "VT": 4,
  "HI": 1,
  "CT": 1,
  "TN": 1,
  "AL": 2,
  "CA": 5,
  "LA": 2,
  "NC": 1,
  "SC": 1,
  "NJ": 3,
  "GA": 2,
  "KY": 2,
  "MA": 2,
  "MO": 1,
  "DE": 1,
  "WI": 1,
  "NH": 1,
  "AR": 2,
  "MT": 1,
  "AZ": 1
}