{
  "NY": 32,
  "NM": 5,
  "ND": 3,
  "TX": 62,
  "MD": 14,
  "OK": 5,
  "MS": 5,
  "WA": 45,
  "ME": 12,
  "MI": 12,
  "CO": 11,
  "VA": 6,
  "FL": 28,
  "OR": 2,
  "VT": 5,
  "HI": 4,
  "CT": 2,
  "TN": 9,
  "AL": 5,
  "CA": 36,
  "LA": 7,
  "NC": 11,
  "SC": 4,
  "NJ": 6,
  "GA": 14,
  "KY": 4,
  "MA": 5,
  "MO": 2,
  "DE": 2,
  "WI": 4,
  "NH": 4,
  "AR": 3,
  "MT": 4,
  "AZ": 7,
  "MN": 13,
  "AK": 13,
  "UT": 8,
  "IN": 4,
  "ID": 4,
  "IA": 2,
  "PA": 2,
  "NE": 2,
  "NV": 2,
  "RI": 1,
  "IL": 5,
  "OH": 2,
  "KS": 2,
  "WY": 1,
  "SD": 1
}