{
  "NY": 14,
  "NM": 3,
  "ND": 2,
  "TX": 16,
  "MD": 8,
  "OK": 4,
  "MS": 1,
  "WA": 14,
  "ME": 5,
  "MI": 5,
  "CO": 7,
  "VA": 3,
  "FL": 13,
  "OR": 2,
  "VT": 4,
  "HI": 2,
  "CT": 1,
  "TN": 5,
  "AL": 3,
  "CA": 17,
  "LA": 5,
  "NC": 6,
  "SC": 2,
  "NJ": 4,
  "GA": 3,
  "KY": 3,
  "MA": 3,
  "MO": 1,
  "DE": 2,
  "WI": 3,
  "NH": 1,
  "AR": 3,
  "MT": 1,
  "AZ": 2,
  "MN": 11,
  "AK": 3,
  "UT": 1,
  "IN": 1,
  "ID": 2,
  "IA": 1
}