{
  "NY": 8,
  "NM": 1,
  "ND": 2,
  "TX": 11,
  "MD": 6,
  "OK": 4,
  "MS": 1,
  "WA": 8,
  "ME": 2,
  "MI": 3,
  "CO": 3,
  "VA": 1,
  "FL": 9,
  "OR": 1,
  "VT": 4,
  "HI": 1,
  "CT": 1,
  "TN": 1,
  "AL": 2,
  "CA": 4,
  "LA": 1,
  "NC": 1,
  "SC": 1,
  "NJ": 2,
  "GA": 2,
  "KY": 2,
  "MA": 2,
  "MO": 1,
  "DE": 1,
  "WI": 1
}