{
  "NY": 10,
  "NM": 2,
  "ND": 2,
  "TX": 12,
  "MD": 7,
  "OK": 4,
  "MS": 1,
  "WA": 12,
  "ME": 3,
  "MI": 4,
  "CO": 5,
  "VA": 1,
  "FL": 10,
  "OR": 2,
  "VT": 4,
  "HI": 1,
  "CT": 1,
  "TN": 1,
  "AL": 2,
  "CA": 8,
  "LA": 2,
  "NC": 5,
  "SC": 1,
  "NJ": 3,
  "GA": 2,
  "KY": 2,
  "MA": 3,
  "MO": 1,
  "DE": 2,
  "WI": 1,
  "NH": 1,
  "AR": 3,
  "MT": 1,
  "AZ": 1,
  "MN": 1,
  "AK": 1,
  "UT": 1
}