{
  "NY": 4,
  "NM": 1,
  "ND": 1,
  "TX": 5,
  "MD": 5,
  "OK": 2,
  "MS": 1,
  "WA": 3,
  "ME": 1,
  "MI": 3,
  "CO": 2,
  "VA": 1,
  "FL": 1,
  "OR": 1,
  "VT": 2,
  "HI": 1
}