{
  "NY": 6,
  "NM": 1,
  "ND": 1,
  "TX": 7,
  "MD": 6,
  "OK": 3,
  "MS": 1,
  "WA": 4,
  "ME": 1,
  "MI": 3,
  "CO": 2,
  "VA": 1,
  "FL": 5,
  "OR": 1,
  "VT": 3,
  "HI": 1,
  "CT": 1,
  "TN": 1,
  "AL": 1
}