{
  "NY": 33,
  "NM": 5,
  "ND": 3,
  "TX": 63,
  "MD": 14,
  "OK": 5,
  "MS": 5,
  "WA": 46,
  "ME": 15,
  "MI": 12,
  "CO": 12,
  "VA": 7,
  "FL": 28,
  "OR": 3,
  "VT": 5,
  "HI": 4,
  "CT": 2,
  "TN": 10,
  "AL": 5,
  "CA": 37,
  "LA": 8,
  "NC": 11,
  "SC": 6,
  "NJ": 6,
  "GA": 14,
  "KY": 4,
  "MA": 5,
  "MO": 2,
  "DE": 2,
  "WI": 5,
  "NH": 4,
  "AR": 3,
  "MT": 4,
  "AZ": 8,
  "MN": 13,
  "AK": 13,
  "UT": 10,
  "IN": 5,
  "ID": 4,
  "IA": 2,
  "PA": 2,
  "NE": 2,
  "NV": 2,
  "RI": 1,
  "IL": 9,
  "OH": 2,
  "KS": 2,
  "WY": 1,
  "SD": 1
}