{
  "NY": 1,
  "NM": 1,
  "ND": 1,
  "TX": 2,
  "MD": 2,
  "OK": 1,
  "MS": 1
}