{
  "NY": 31,
  "NM": 5,
  "ND": 3,
  "TX": 61,
  "MD": 14,
  "OK": 5,
  "MS": 4,
  "WA": 45,
  "ME": 12,
  "MI": 9,
  "CO": 11,
  "VA": 6,
  "FL": 28,
  "OR": 2,
  "VT": 5,
  "HI": 3,
  "CT": 2,
  "TN": 9,
  "AL": 5,
  "CA": 35,
  "LA": 7,
  "NC": 10,
  "SC": 4,
  "NJ": 6,
  "GA": 14,
  "KY": 3,
  "MA": 5,
  "MO": 2,
  "DE": 2,
  "WI": 4,
  "NH": 4,
  "AR": 3,
  "MT": 4,
  "AZ": 7,
  "MN": 13,
  "AK": 13,
  "UT": 8,
  "IN": 4,
  "ID": 3,
  "IA": 2,
  "PA": 2,
  "NE": 2,
  "NV": 2,
  "RI": 1,
  "IL": 4,
  "OH": 2,
  "KS": 2,
  "WY": 1
}